15 15
0 14 0 0 0 0 0 0 0 0 0 14 9 0 0
14 0 9 0 0 0 0 0 0 0 17 9 0 0 0
0 9 0 5 0 0 0 0 0 20 13 0 0 0 0
0 0 5 0 17 0 0 0 0 19 0 0 0 0 0
0 0 0 17 0 16 0 0 0 4 0 0 0 0 0
0 0 0 0 16 0 8 9 0 12 0 0 0 0 0
0 0 0 0 0 8 0 6 0 0 0 0 0 0 0
0 0 0 0 0 9 6 0 7 12 0 0 0 23 10
0 0 0 0 0 0 0 7 0 13 5 0 0 0 6
0 0 20 19 4 12 0 12 13 0 7 0 0 0 0
0 17 13 0 0 0 0 0 5 7 0 18 0 0 8
14 9 0 0 0 0 0 0 0 0 18 0 15 0 9
9 0 0 0 0 0 0 0 0 0 0 15 0 11 15
0 0 0 0 0 0 0 23 0 0 0 0 11 0 18
0 0 0 0 0 0 0 10 6 0 8 9 15 18 0